==========@=========
=                  =
=                  =
=                  =
=                  =
=                  =
=                  =
@                  @
=                  =
=                  =
=                  =
=                  =
=                  =
=                  =
==========@=========